"Rank","Nation","Gold","Silver","Bronze","Total"
"1","New Zealand","21","13","2","36"
"2","Australia","7","9","7","23"
"3","Fiji","3","7","16","26"
"4","New Caledonia","1","4","1","6"
"5","Tahiti","1","0","1","2"
"6","Tonga","1","0","0","1"
"7","Guam","0","1","0","1"
"8","Papua New Guinea","0","0","2","2"
"9","Cook Islands","0","0","1","1"
"9","Niue","0","0","1","1"
