"Rank","Nation","Gold","Silver","Bronze","Total"
"1","Germany","7","9","8","24"
"2","England","4","3","1","8"
"3","Poland","3","4","2","9"
"4","Hungary","3","3","5","11"
"5","Japan","3","3","4","10"
"6","France","2","0","1","3"
"7","Estonia","1","0","1","2"
"8","New Zealand","1","0","0","1"
"9","Austria","0","2","0","2"
"10","Latvia","0","0","1","1"
"Total","Total","24","24","23","71"
