"Player","Team","GP","G","A","Pts"
"Eric Lindros","Phi","19","12","14","26"
"Joe Sakic","Col","17","8","17","25"
"Claude Lemieux","Col","17","13","10","23"
"Valeri Kamensky","Col","17","8","14","22"
"Rod Brind'Amour","Phi","19","13","8","21"
"John LeClair","Phi","19","9","12","21"
"Wayne Gretzky","NYR","15","10","10","20"
"Sergei Fedorov","Det","20","8","12","20"
"Brendan Shanahan","Det","20","9","8","17"
"Peter Forsberg","Col","14","5","12","17"
"Sandis Ozolinsh","Col","17","4","13","17"
