"Player","Pos","GP","G","A","Pts","P/G"
"Wes Goldie","RW","31","17","17","34","1.09"
"Milan Gajic","RW","27","7","14","21",".78"
"Chad Painchaud","RW","17","9","4","13",".76"
"Kiel McLeod","C","21","7","6","13",".62"
"Matt Kelly","D","23","1","12","13",".57"
"Patrick Coulombe","D","26","1","11","12",".46"
"Rob Hennigar","C","11","0","12","12","1.09"
"Ryan Wade","RW","22","7","4","11",".50"
"Chris St. Jacques","C","20","4","7","11",".55"
"Olivier Filion","C","14","5","5","10",".71"
