"Rank","Country","1st place","2nd place","3rd place","Total"
"1","Soviet Union","18","1","0","19"
"2","Russia","6","3","1","10"
"3","United States","5","5","9","19"
"4","Hungary","3","6","2","11"
"5","Armenia","3","0","3","6"
"6","Ukraine","2","1","3","6"
"7","Yugoslavia","1","6","5","12"
"8","Poland","1","2","3","6"
"9","Germany ","1","1","3","5"
"10","England","0","3","3","6"
"11","Argentina","0","3","2","5"
"12","Czechoslovakia","0","2","1","3"
"13","Netherlands","0","1","1","2"
"13","Sweden","0","1","1","2"
"13","Israel","0","1","1","2"
"16","Bosnia and Herzegovina","0","1","0","1"
"16","China","0","1","0","1"
"16","Denmark","0","1","0","1"
"16","Uzbekistan","0","1","0","1"
"20","Bulgaria","0","0","1","1"
"20","Estonia","0","0","1","1"
